#####        
      ##### #
## ####   # #
#B #  # # # #
####  # # # #
      # # # #
A# #    #   #
